0 0 0 0 0 0 0 0 0 0 0 0 0 0 0 0 0 0
0 3 1 5 8 6 9 4 7 5 1 2 9 2 8 3 6 0
0 1 5 8 3 2 8 4 6 9 3 7 4 6 8 9 3 0
0 1 6 2 9 3 5 8 9 2 6 1 8 9 7 3 1 0
0 5 7 5 8 1 3 4 8 5 1 5 8 9 3 5 2 0
0 9 4 7 5 1 2 9 4 7 5 1 2 9 2 8 3 0
0 8 4 6 9 3 7 8 4 6 9 3 7 4 6 8 9 0
0 5 8 9 2 6 1 5 8 9 2 6 1 8 9 7 3 0
0 3 8 1 3 4 8 5 1 5 3 8 1 3 4 8 5 0
0 7 5 1 2 9 4 7 5 1 7 5 1 2 9 4 7 0
0 6 9 3 7 8 4 6 9 3 6 9 3 7 8 4 6 0
0 9 2 6 1 5 8 9 2 3 4 8 5 1 5 8 9 0
0 8 4 6 9 3 7 3 7 2 9 4 7 5 1 2 9 0
0 5 8 9 2 6 1 6 1 7 8 4 6 9 3 7 4 0
0 3 8 1 3 4 8 2 9 1 5 8 9 2 6 1 8 0
0 7 5 1 2 9 4 8 1 3 4 8 8 4 6 8 4 0
0 8 4 6 9 3 7 5 1 2 9 4 5 8 9 5 8 0
0 0 0 0 0 0 0 0 0 0 0 0 0 0 0 0 0 0